C C C C C C C C C C C C C C C C C C C C C C C G G G G G G G G G G G G G O O O O O O O O O O O O N N H H H H H H H H H H H H D D D D D D D D D D D D D D R R R R 
C C C C C C C C C C C C C C C C C C C C C C C G G G G G G G G G G G G G O O O O O O O O O O O O H H H H H H H H H H H H H H H H D D D D D D D D D D R R R R R R 
U U U U U U C C C C C C C C C C C C C C C C G G G G G G G G G G G G G G O O O O O O O O O O O O H H H H H H H H H H H H H H H H H H D D D D D D R R R R R R R R 
U U U U U U U U U C C C C C C C C C C C C C G G G G G G G G G G G G G G O O O O O O O O O O O H H H H H H H H H H H H H H H H H H H H H D D D R R R R R R R R R 
U U U U U U U U U U U C C C C C C C C C C G G G G G G G G G G G G G G G O O O O O O O O O X H H H H H H H H H H H H H H H H H H H H H H H D R R R R R R R R R R 
U U U U U U U U U U U U U C C C C C C C G G G G G G G G G G G G G G G G G O O O O O O O X X H H H H H H H H H H H H H H H H H H H H H H H H R R R R R R R R R R 
U U U U U U U U U U U U U U U U C C C G G G G G G G G G G G G G G G G G G O O O O O O X X H H H H H H H H H H H H H H H H H H H H H H H H H H R R R R R R R R R 
U U U U U U U U U U U U U U U U U U U G G G G G G G G G G G G G G G G G O O O O O O X X H H H H H H H H H H H H H H H H H H H H H H H H H H H H R R R R R R R R 
Y Y Y Y Y U U U U U U U U U U U U U U U G G G G G G G G G G G G G G G G O O O O X X X H H H H H H H H H H H H H H H H H H H H H H H H H H H H H Q Q Q R R R R R 
Y Y Y Y Y Y Y U U U U U U U U U U U U U U G G G G G G G G G G G G G G G O O O X X X X H H H H H H H H H H H H H H H H H H H H H H H H H H H H H H Q Q Q Q R R R 
Y Y Y Y Y Y Y Y Y U U U U U U U U U U U U U G G G G G G G G G G G G G G O O X X X X H H H H H H H H H H H H H H H H H H H H H H H H H H H H H H H Q Q Q Q Q Q Q 
Y Y Y Y Y Y Y Y Y Y U U U U U U U U U U U U G G G G G G G G G G G G G G O X X X X H H H H H H H H H H H H H H H H H H H H H H H H H H H H H H H H Q Q Q Q Q Q Q 
Y Y Y Y Y Y Y Y Y Y Y U U U U U U U U U U U U G G G G G G G G G G G G G X X X X H H H H H H H H H H H H H H H H H H H H H H H H H H H H H H H H H Q Q Q Q Q Q Q 
Y Y Y Y Y Y Y Y Y Y Y Y U U U U U U U U U U U G G G G G G G G G G G G G X X X S H H H H H H H H H H H H H H H H H H H H H H H H H H H H H H H H H H Q Q Q Q Q Q 
Y Y Y Y Y Y Y Y Y Y Y Y Y U U U U U U U U U U H G G G G G G G G G G G G X S S S H H H H H H H H H H H H H H H H H H L L L H H H H H H H H H H H H H Q Q Q Q Q Q 
Y Y Y Y Y Y Y Y Y Y Y Y Y U U U U U U U U U H H H G G G G G G G G G G S S S S H H H H H H H H H H H H H H H L L L L L L L L L L L H H H H H H H H H Q Q Q Q Q Q 
Y Y Y Y Y Y Y Y Y Y Y Y Y Y U U U U U U U U H H H H G G G G G G G G G S S S S H H H H H H H H H H H H H L L L L L L L L L L L L L L L H H H H H H H H Q Q Q Q Q 
Y Y Y Y Y Y Y Y Y Y Y Y Y Y Y U U U U U U H H H H H H H G G G G G G G S S S S H H H H H H H H H H H H L L L L L L L L L L L L L L L L L H H H H H H H Q Q Q Q Q 
Y Y Y Y Y Y Y Y Y Y Y Y Y Y Y U U U U U U H H H H H H H H G G G G G S S S S H H H H H H H H H H H H L L L L L L L L L L L L L L L L L L L L H H H H H Q Q Q Q Q 
Y Y Y Y Y Y Y Y Y Y Y Y Y Y Y U U U U U H H H H H H H H H H G G G G S S S S H H H H H H H H H H H L L L L L L L L L L L L L L L L L L L L L L H H H H H Q Q Q Q 
Y Y Y Y Y Y Y Y Y Y Y Y Y Y Y X U U U H H H H H H H H H H H H H G G S S S S H H H H H H H H H H H L L L L L L L L L L L L L L L L L L L L L L L H H H H Q Q Q Q 
Y Y Y Y Y Y Y Y Y Y Y Y Y Y Y X X U U H H H H H H H H H H H H H G G S S S S H H H H H H H H H H L L L L L L L L L L L L L L L L L L L L L L L L K H H H Q Q Q Q 
Y Y Y Y Y Y Y Y Y Y Y Y Y Y Y X X K K H H H H H H H H H H H H H G S S S S S H H H H H H H H H H L L L L L L L L L L L L L L L L L L L L L L L L L K H H Q Q Q Q 
Y Y Y Y Y Y Y Y Y Y Y Y Y Y Y X K N N N N N N H H H H H H H H H H S S S S S H H H H H H H H H L L L L L L L L L L L L L L L L L L L L L L L L L L K K H Q Q Q Q 
Y Y Y Y Y Y Y Y Y Y Y Y Y Y Y Y N N N N N N N N N H H H H H H H H S S S S S H H H H H H H H H L L L L L L L L L L L L L L L L L L L L L L L L L L K K K Q Q Q Q 
Y Y Y Y Y Y Y Y Y Y Y Y Y Y Y N N N N N N N N N N N H H H H H H H S S S S S H H H H H H H H H L L L L L L L L L L L L L L L L L L L L L L L L L L K K K Q Q Q Q 
Y Y Y Y Y Y Y Y Y Y Y Y Y Y Y N N N N N N N N N N N N H H H H H H S S S S S H H H H H H H H H L L L L L L L L L L L L L L L L L L L L L L L L L L K K K K Q Q Q 
Y Y Y Y Y Y Y Y Y Y Y Y Y Y N N N N N N N N N N N N N N H H H H H H S S S S S H H H H H H H L L L L L L L L L L L L L L L L L L L L L L L L L L L L K K K Q Q Q 
Y Y Y Y Y Y Y Y Y Y Y Y Y N N N N N N N N N N N N N N N N H H H H H S S S S S H H H H H H H E L L L L L L L L L L L L L L L L L L L L L L L L L L L K K K Q Q Q 
Y Y Y Y Y Y Y Y Y Y Y Y N N N N N N N N N N N N N N N N N N H H H H S S S S S H H H H H H H E L L L L L L L L L L L L L L L L L L L L L L L L L L K K K K Q Q Q 
Y Y Y Y Y Y Y Y Y Y Y N N N N N N N N N N N N N N N N N N N H H H H H S S S S H H H H H H H E L L L L L L L L L L L L L L L L L L L L L L L L L L K K K K Q Q Q 
Y Y Y Y Y Y Y Y Y Y N N N N N N N N N N N N N N N N N N N N H H H H H S S S S S H H H H H H E L L L L L L L L L L L L L L L L L L L L L L L L L L K K H K Q Q Q 
Y Y Y Y Y Y Y Y N N N N N N N N N N N N N N N N N N N N N N N H H H H S S S S S H H H H H H E L L L L L L L L L L L L L L L L L L L L L L L L L L K K H K Q Q Q 
Y Y Y Y Y Y Y N N N N N N N N N N N N N N N N N N N N N N N N H H H H H S S S S H H H H H E E E L L L L L L L L L L L L L L L L L L L L L L L L L K H H Q Q Q Q 
Y Y Y Y N N N N N N N N N N N N N N N N N N N N N N N N N N H H H H H H S S S S S H H H H E E E L L L L L L L L L L L L L L L L L L L L L L L L K K H H Q Q Q Q 
V V V V V V V N N N N N N N N N N N N N N N N N N N N N N N H H H H H H S S S S S H H H H E E E E L L L L L L L L L L L L L L L L L L L L L L L K H H H Q Q Q Q 
V V V V V V V V V V N N N N N N N N N N N N N N N N N N N H H H H H H H H S S S S S S H E K E E E E L L L L L L L L L L L L L L L L L L L L L K H H H H Q Q Q Q 
V V V V V V V V V V V V N N N N N N N N N N N N N N N N N H H H H H H H H S S S S S S S K K K K K E L L L L L L L L L L L L L L L L L L L L L H H H H H K Q Q Q 
V V V V V V V V V V V V V V N N N N N N N N N N N N N N N H H H H H H H S S S S S S S S K K K K K K K L L L L L L L L L L L L L L L L L L L H H H H H K K Q Q Q 
V V V V V V V V V V V V V N N N N N N N N N N N N N N N N H H H H H H H S S S S S S S S S K K K K K K K K L L L L L L L L L L L L L L L K K K K K K K K K Q Q Q 
V V V V V V V V V V V V V V N N N N N N N N N N N N N N N H H H H H H S S S S S S S S S S K K K K K K K K K K L L L L L L L L L L L K K K K K K K K K K K K Q Q 
V V V V V V V V V V V V V V V N N N N N N N N N N N N N N H H H H H H S S S S S S S S S S S K K K K K K K K K K K K K K K K K K K K K K K K K K K K K O O O O Q 
V V V V V V V V V V V V V V V V V V V V N N N N N N N N N H H H H H H S S S S S S S S S S S S K K K K K K K K K K K K K K K K K K K K K K K K K K K K K O O O O 
V V V V V V V V V V V V V V V V V V V V V V N N N N N N N H H H H H S S S S S S S S S S S S K K K K K K K K K K K K K K K K K K K K K K K K K K K K K K K O O O 
V V V V V V V V V V V V V V V V V V V V V V N N N N N N N H H H H H S S S S S S S S S S S S K K K K K K K K K K K K K K K K K K K K K K K K K K K K K K K O O O 
V V V V V V V V V V V V V V V V V V V V V V N N N N N N H H H H H S S S S S S S S S S S S S S K K K K K K K K K K K K K K K K K K K K K K K K K K O O O O O O O 
V V V V V V V V V V V V V V V V V V V V V V N N N N N N H H H H S S S S S S S S S S S S S S S S K K K K K K K K K K K K K K K K K K K K K K K K K O O O O O O O 
V V V V V V V V V V V V V V V V V V V V V V N N N N N H H H H S S S S S S S S S S S S S S S S S S K K K K K K K K K K K K K K K K K K K K K K K K K K O O O K K 
V V V V V V V V V V V V V V V V V V V V V N N N N N N H H S S S S S S S S S S S S S S S S S S S S S K K K K K K K K K K K K K K K K K K K K K K K K K K K K K K 
V V V V V V V V V V V V V V V V V V V V V N N N N N H H S S S S X X X S S S S S S S S S S S S S S S S K K K K K K K K K K K K K K K K K K K K K K K K K K K K K 
V V V V V V V V V V V V V V V V V V V V V N N N N N H S S S S X X X X X S S S I I S S S S S S S S S S S S K K K K K K K K K K K K K K K K K K K K K K K K K K K 
V V V V V V V V V V V V V V V V V V V V V N N N N S S S S X X X X X X I I I I I I I I I I I S S S S S S S S S K K K K K K K K K K K K K K K K K K K K K K K K K 
V V V V V V V V V V V V V V V V V V V V F F F F U S S S X X X X X X X I I I I I I I I I I I I I I I I I I S S S S S S G K K K K K K K K K K K K K K K K K K K K 
V V V V V V V V V V V V V V V V V V F F F F F F U S S X X X X X X X I I I I I I I I I I I I I I I I I I I I I I G G I I I I K K K K K K K K K K K K K K K K K K 
V V V V V V V V V V V V V V V V F F F F F F F U U S X X X X X X X I I I I I I I I I I I I I I I I I I I I I I I I I I I I I I K K K K K K K K K K K K K K K K K 
V V V V V V V V V V V V V V V F F F F F F F U U D X X X X X X X I I I I I I I I I I I I I I I I I I I I I I I I I I I I I I I K K K K K K K K K K K K K K K K K 
V V V V V V V V V V V V V F F F F F F F F U U D D D X X X X X X I I I I I I I I I I I I I I I I I I I I I I I I I I I I I I I I K K K K K K K K K K K K K K K K 
V V V V V V V V V V V V F F F F F F F U U D D D D D X X X X X I I I I I I I I I I I I I I I I I I I I I I I I I I I I I I I I I K K K K K K K K K K K K K K K K 
V V V V V V V V V V V F F F F F F F U D D D D D D D D X X X X I I I I I I I I I I I I I I I I I I I I I I I I I I I I I I I I I K K K K K K K K K K K K K K K K 
V V V V V V V V V V F F F F F H U U D D D D D D D D D D X X X I I I I I I I I I I I I I I I I I I I I I I I I I I I I I I I I I I K K K K K K K K K K K K K K K 
V V V V V V V V F F F F F F F U D D D D D D D D D D D D D X I I I I I I I I I I I I I I I I I I I I I I I I I I I I I I I I I I I I K K K K K K K K K K K K K K 
V V V V V V V F F F F F F F D D D D D D D D D D D D D D D D I I I I I I I I I I I I I I I I I I I I I I I I I I I I I I I I I I I I I K K K K K K K K K K K K K 
V V V V V V F F F F F F P D D D D D D D D D D D D D D D D D B I I I I I I I I I I I I I I I I I I I I I I I I I I I I I I I I I I I I I I K K K K K K K K K K K 
V V V V F F F F F F P D D D D D D D D D D D D D D D D D D D B B B I I I I I I I I I I I I I I I I I I I I I I I I I I I I I I I I I I I I K K K K K K K K K K K 
V V V F F F F F F P D D D D D D D D D D D D D D D D D D D D B B B B I I I I I I I I I I I I I I I I I I I I I I I I I I I I I I I I I I I K K K K K K K K K K K 
V V F F F F F P P D D D D D D D D D D D D D D D D D D D D B B B B B B B I I I I I I I I I I I I I I I I I I I I I I X X I I I I I I I I I K K K K K K K L K L G 
V F F F F F P D D D D D D D D D D D D D D D D D D D D D D D B B B B B B B I I I I I I I I I I I I I I I I I I I I I I X X I I I I I I I I I K K L L L L L L L G 
F F F F F P D D D D D D D D D D D D D D D D D D D D D D D D B B B B B B B B B I I I I I I I I I I I I I I I I I I I I X X X X I I I I I I L L L L L L L L L L L 
F F F P P D D D D D D D D D D D D D D D D D D D D D D D D D D B B B B B B B B B I I I I I I I I I I I I I I I I I I I I X X X X I I I L L L L L L L L L L L L L 
F F P P D D D D D D D D D D D D D D D D D D D D D D D D D D D B B B B B B B B B B I I I I I I I I I I I I I I I I I I I X X X X X X L L L L L L L L L L L L L L 
U U P D D D D D D D D D D D D D D D D D D D D D D D D D D D D B B B B B B B B B B X I I I I I I I I I I I I I I I I I I I X X L L L L L L L L L L L L L L L L L 
U D D D D D D D D D D D D D D D D D D D D D D D D D D D D D D D B B B B B B B B B B X I I I I I I I I I I I I I I I I I I L L L L L L L L L L L L L L L L L L L 
D D D D D D D D D D D D D D D D D D D D D D D D D D D D D D D D B B B B B B B B B B X X I I I I I I I I I I I I I I I I I L L L L L L L L L L L L L L L L L L L 
D D D D D D D D D D D D D D D D D D D D D D D D D D D D D D D D D B B B B B B B B B X X X I I I I I I I I I I I I I I I L L L L L L L L L L L L L L L L L L L L 
D D D D D D D D D D D D D D D D D D D D D D D D D D D D D D D D D B B B B B B B B B S S X I I I I I I I I I I I I I I I L L L L L L L L L L L L L L L L L L L L 
D D D D D D D D D D D D D D D D D D D D D D D D D D D D D D D D D B B B B B B B B B S S X X I I I I I I I I I I I I I G L L L L L L L L L L L L L L L L L L L L 
D D D D D D D D D D D D D D D D D D D D D D D D D D D D D D D D D B B B B B B B B B S S S X I I I I I I I I I I I I G G G L L L L L L L L L L L L L L L L L L L 
D D D D D D D D D D D D D D D D D D D D D D D D D D D D D D D D D B B B B B B B B B S S S X X I I I I I I I I I I G G G G L L L L L L L L L L L L L L L L L L L 
D D D D D D D D D D D D D D D D D D D D D D D D D D D D D D D D D B B B B B B B B B S S S S X I I I I I I I I I G G G G L L L L L L L L L L L L L L L L L L L L 
D D D D D D D D D D D D D D D D D D D D D D D D D D D D D D D D D B B B B B B B B B S S S S X I I I I I I I I I G G G G L L L L L L L L L L L L L L L L L L L L 
