K K K K K K G G G G G G H H H H H H H H D D D D D D D D D D D D D D D D D D D D D D N N N O O O O O O O O O O O O O O O O O O O O O O O O O 
K K K K K K G G G G G G G H H H H H H H D D D D D D D D D D D D D D D D D D D D D N N N N O O O O O O O O O O O O O O O O O O O O O O O O O 
K K K K K K K G G G G G G H H H H H H H D D D D D D D D D D D D D D D D D D D D D N N N O O O O O O O O O O O O O O O O O O O O O O O O O O 
K K K K K K K G G G G G G H H H H H H H D D D D D D D D D D D D D D D D D D D D N N O O O O O O O O O O O O O O O O O O O O O O O O O O O O 
K K K K K K K X G G G G G G H H H H H H H D D D D D D D D D D D D D D D D D D D O O O O O O O O O O O O O O O O O O O O O O O O O O O O O O 
K K K K K K X X X E E G G G G H H H H H H D D D D D D D D D D D D D D D D D D O O O O O O O O O O O O O O O O O O O O O O O O O O O O O O O 
K K K K C C C C E E E E G G G G H H H H H H D D D D D D D D D D D D D D D D O O O O O O O O O O O O O O O O O O O O O O O O O O O O S S S S 
K K K C C C C C C E E E E E E E G H H H H H H D D D D D D D D D D D D D D O O O O O O O O O O O O O O O O O O O O O O O O O O O S S S S S S 
X X C C C C C C C E E E E E E E G G H H H H H H D D D D D D D D D D D O O O O O O O O O O O O O O O O O O O O O X X X O O O L L L L L L L S 
X X X C C C C C C E E E E E E E E G G H H H H H H D D D D D D D D O O O O O O O O O O O O O O O O X X X X X X X X X X S S L L L L L L L L L 
X X X X C C C C E E E E E E E E E E G G H H H H H H H H D D O O O O O O O O O O O O O O O O H G X X X X X X X X X S S S S L L L L L L L L L 
X X X X X X X X E E E E E E E E E E E G G G H H H H H H O O O O O O O O O O O O O O O O O H G G G G G X X X X X S S S S S L L L L L L L L L 
X X X X X X X X E E E E E E E E E E E E E G G G H N N O O O O O O O O O O O O O O O O G G G G G G G G X X X X S S S S S S S L L L L L L L L 
X X X X X X X E E E E E E E E E E E E E E E G G G G O O O O O O O O O O O O O O G G G G G G G G G G G X X X S S S S S S S S D D L L L L L L 
X X X X X X E E E E E E E E E E E E E E E E E E G G G G G G G G G G G G G G G G G G G G G G G G G G G G X S S S S S S S S S D L L L L L L L 
X X X X X E E E E E E E E E E E E E E E E E E G G G G G G G G G G G G G E E E E E G G G G G G G G G G G S S S S S S S S S K K K L L L L L L 
X X X X X E E E E E E E E E E E E E E E E E E G G G G G G G K K K E C C C C C C C C G G G G G G G G G G S S S S S S S S K K K K K K K L L L 
X X X X E E E E E E E E E E E E E E E E E K K K K K K K K K K C C C C C C C C C C C C H G G G G G G G G S S S S S S S E E K K K K K K K K K 
X X X E E E E E E E E E E E E E E E E E K K K K K K K K K E C C C C C C C C C C C C C H G G G G G G G S S S S S S H H E E E E E E E E E E E 
X X X X E E E E E E E E X X X X X X X X Z Z K K K K K K E C C C C C C C C C C C C C C H G G G G G G G S S S S H H H H E E E E E E E E E E E 
X X X X X X X X X X X X X X X X X X X X X X X X X X E E E C C C C C C C C C C C C C C C G G G G G G G S S H H H H H H H E E E E E L L L L L 
X X X X X X X X X X X X X X X X X X X X X X X X X X X E C C C C C C C C C C C C C C C C G G G G G G S S S H H H H H H H E E E E L L L L L L 
I I I X X X X X X X X X S S S X X X X X X X X X X X X X X C C C C C C C C C C C C C C K G G G G G G S S H H H H H H H H E E L L L L L L L L 
I I I X X X X X X S S S S S S S X X X X X X X X X X X X X C C C C C C C C C C C C C C K K G G G G S S S H H H H H H H H H L L L L L L L L L 
I I I X X X X X S S S S S S S S X X X X X X X X X X X X X C C C C C C C C C C C C C K K K K G G G S S H H H H H H H H H H L L L L L L L L L 
I I I X X X X S S S S S S S S S X X X X X X X X X X X X X X C C C C C C C C C C C K K K K K K K G S S H H H H H H H H H L L L L L L L L L L 
I I I X X X S S S S S S S S S S S X X X X X X X X X X X Z X C C C C C C C C C C C K K K K K K K K S H H H H H H H H H H L L L L L L L L L L 
I I I I X S S S S S S S S S S S S X X X X X X X X X X X X X C C C C C C C C C C C K K K K K K K K S H H H H H H H H H H L L L L L L L L L L 
I I I I S S S S S S S S S S S S S X X X X X X X X X X X X X X C C C C C C C C C K K K K K K K K K S H H H H H H H H H H L L L L L L L L L L 
I I I I S S S S S S S S S S S S S X X X X X X X X X X X X X X X X C C C C C C K K K K K K K K K K H H H H H H H H H H L L L L L L L L L L L 
I I I I S S S S S S S S S S S S S X X X X X X X X X X X X X X X X X X C C C K K K K K K K K K K K H H H H H H H H H H L L L L L L L L L L L 
I I I I S S S S S S S S S S S S X X X X X X X X X X X X X X X X X X X K K K K K K K K K K K K K K H H H H H H H H H H H L L L L L L L L L L 
I I I I S S S S S S S S S S S X X X X X X X X X X X X X X X X X X X X X K K K K K K K K K K K K K H H H H H H H H H H H L L L L L L L L L L 
I I I I S S S S S S S S S S X X X X X X X X X X X X X X X X X X X X X X K K K K K K K K K K K K K H H H H H H H H H H H L L L L L L L L L L 
I I I I X X S X X X X X X X X X X X X X X X X X X X X X X X U U U U U U U K K K K K K K K K K K K H H H H H H H H H H H L L L L L L L L L L 
I I I I X X X X X X X X X X X X X X X X X X X X X X X U U U U U U U U U U U U K K K K K K K K K K H H H H H H H H H H H H L L L L L L L L L 
I I I I X X X X X X X X X X X X X X X X X X X X X U U U U U U U U U U U U U U U K K K K K K K K K H H H H H H H H H H H H L L L L L L L L L 
I I I I I X X X X X X X X X X X X X X X X X X X U U U U U U U U U U U U U U U U U K K K K K K K K K H H H H H H H H H H H H L L L L L L L L 
I I I I I X X X X X X X X X X X X X X X X I I U U U U U U Y Y Y Y U U U U U U U U U K K K K K K K K H H H H H H H H H H H H H L L L L L L L 
I I I I I I X X X X X X X X X X X X X I I I U U U Y Y Y Y Y Y Y Y Y Y Y U U U U U U K K K K K K K K H H H H H H H H H H H H H H L L L L L L 
I I I I I I X X X X X X X X X X X I I I Y Y Y Y Y Y Y Y Y Y Y Y Y Y Y Y Y Y U U U U U H K K K K K K H H H H H H H H H H H H H H H H L L L L 
I I I I I I I X X X X X X X I I I I I Y Y Y Y Y Y Y Y Y Y Y Y Y Y Y Y Y Y Y Y U U U U H H K K K K T T H H H H H H H H H H H H H H H H H H H 
I I I I I I I I I I I I I I I I I I Y Y Y Y Y Y Y Y Y Y Y Y Y Y Y Y Y Y Y Y Y Y U U U U H T T T T T T H H H H H H H H H H H H H H H H H H H 
I I I I I I I I I I I I I I I I I Y Y Y Y Y Y Y Y Y Y Y Y Y Y Y Y Y Y Y Y Y Y Y Y U U U H T T T T T T T H H H H H H H H H H H H H H H H H H 
I I I I I I I I I I I I I I I I Y Y Y Y Y Y Y Y Y Y Y Y Y Y Y Y Y Y Y Y Y Y Y Y Y U U U U T T T T T T T T H H H H H H H H H H H H H H H H H 
I I I I I F F F I I I I I I Y Y Y Y Y Y Y Y Y Y Y Y Y Y Y Y Y Y Y Y Y Y Y Y Y Y Y U U U U T T T T T T T T T H H H H H H H H H H H H H H H H 
F F F F F F F F F F F F Y Y Y Y Y Y Y Y Y Y Y Y Y Y Y Y Y Y Y Y Y Y Y Y Y Y Y Y Y Y U U U A T T T T T T T T T T H H Q Q Q Q Q Q Q Q Q Q Q Q 
F F F F F F F F F F F F Y Y Y Y Y Y Y Y Y Y Y Y Y Y Y Y Y Y Y Y Y Y Y Y Y Y Y Y Y Y U U U A T T T T T T T T T T T Q Q Q Q Q Q Q Q Q Q Q Q Q 
F F F F F F F F F F F Y Y Y Y Y Y Y Y Y Y Y Y Y Y Y Y Y Y Y Y Y Y Y Y Y Y Y Y Y Y Y U U U A T T T T T T T T T T T Q Q Q Q Q Q Q Q Q Q Q Q Q 
F F F F F F F F F F F Y Y Y Y Y Y Y Y Y Y Y Y Y Y Y Y Y Y Y Y Y Y Y Y Y Y Y Y Y Y Y U U U A T T T T T T T T T T T Q Q Q Q Q Q Q Q Q Q Q Q Q 
F F F F F F F F F T T T T T Y Y Y Y Y Y Y Y Y Y Y Y Y Y Y Y Y Y Y Y Y Y Y Y Y Y Y Y U U A A T T T T T T T T T T T Q Q Q Q K K K K Q Q Q Q Q 
F F F F F F V V V V V V V V T T Y Y Y Y Y Y Y Y Y Y Y Y Y Y Y Y Y Y Y Y Y Y Y Y Y U U A A A U T T T T T T T T T T X K K K K K K K K K K K Q 
F F F V V V V V V V V V V V V V T T Y Y Y Y Y Y Y Y Y Y Y Y Y Y Y Y Y Y Y Y Y Y Y U A A A A U U T T T T T T T T R X K K K K K K K K K K K K 
V V V V V V V V V V V V V V V V V V T Y Y Y Y Y Y Y Y Y Y Y Y Y Y Y Y Y Y Y Y Y Y A A A A U U U U T T T T T T R R R K K K K K K K K K K K K 
V V V V V V V V V V V V V V V V V V V Y Y Y Y Y Y Y Y Y Y Y Y Y Y Y Y Y Y Y Y Y A A A A A U U U U U T T T T T R R R K K K K K K K K K K K K 
V V V V V V V V V V V V V V V V V V V V Y Y Y Y Y Y Y Y Y Y Y Y Y Y Y Y Y Y Y A A A A A U U U U U U U T T T R R R R K K K K K K K K K K K K 
V V V V V V V V V V V V V V V V V V V V V Y Y Y Y Y Y Y Y Y Y Y Y Y Y Y Y Y A A A A A A U U U U U U U T T R R R R R R K K K K K K K K K K K 
V V V V V V V V V V V V V V V V V V V V V V Y Y Y Y Y Y Y Y Y Y Y Y Y Y Y A A A A A A U U U U U U U U U T R R R R R R K K K K K K K K K K K 
V V V V V V V V V V V V V V V V V V V V V V V V Y Y Y Y Y Y Y Y Y Y Y Y A A A A A A U U U U U U U U U U R R R R R R R R K K K K K K K K K K 
V V V V V V V V V V V V V V V V V V V V V V V V V Y Y Y Y Y Y Y Y Y A A A A A A A A U U U U U U U U U U R R R R R R R R R K K K K K K K K K 
V V V V V V V V V V V V V V V V V V V V V V V V V V V Y Y Y Y Y A A A A A A A A A U U U U U U U U U U U R R R R R R R R R K K K K K K K Q Q 
V V V V V V V V V V V V V V V V V V V V V V V V V V V V N N N N N A A A A A A A U U U U U U U U U U U U R R R R R R R R R K K K K K K K Q Q 
V V V V V V V V V V V V V V V V V V V V V V V V V V V V V N N N N N N A A A A U U U U U U U U U U U U U R R R R R R R R R K K K K K Q Q Q Q 
V V V V V V V V V V V V V V V V V V V V V V V V V V V V V N N N N N N N A A A U U U U U U U U U U U U U U R R R R R R R R R K K Q Q Q Q Q Q 
V V V V V V V V V V V V V V V V V V V V V V V V V V V V V V N N N N N N A A U U U U U U U U U U U U U U U R R R R R R R R R Q Q Q Q Q Q Q Q 
V V V V V V V V V V V V V V V V V V V V V V V V V V V V V V V N N N N N N U U U U U U U U U U U U U U U U R R R R R R R R Q Q Q Q Q Q Q Q Q 
V V V V V V V V V V V V V V V V V V V V V V V V V V V V V V V N N N N N N A U U U U U U U U U U U U U U U R R R R R R R Q Q Q Q Q Q Q Q Q Q 
V V V V V V V V V V V V V V V V V V V V V V V V V V V V V V V V N N N N N A U U U U U U U U U U U U U U U R R R R R R Q Q Q Q Q Q Q Q Q Q Q 
V V V V V V V V V V V V V V V V V V V V V V V V V V V V V V V V N N N N N A A U U U U U U U U U U U U U U U U R R R Q Q Q Q Q Q Q Q Q Q Q Q 
V V V V V V V V V V V V V V V V V V V V V V V V V V V V V V V V N N N N N A A A U U U U U U U U U U U U U U U U U U Q Q Q Q Q Q Q Q Q Q Q Q 
