C C C C C C C C C C C C C C C C C C C C C C C C C C C I I I I I I I I I I I I I I I I I I I I I I I I I I I I I I I I I I I I I I L L L L L 
C C C C C C C C C C C C C C C C C C C C C C C C C C C I I I I I I I I I I I I I I I I I I I I I I I I I I I I I I I I I I I I I I G L L L L 
C C C C C C C C C C C C C C C C C C C C C C C C C C C I I I I I I I I I I I I I I I I I I I I I I I I I I I I I I I I I I I I I G G L L L L 
C C C C C C C C C C C C C C C C C C C C C C C C C C C I I I I I I I I I I I I I I I I I I I I I I I I I I I I I I I I I I I I I G G L L L L 
G G C C C C C C C C C C C C C C C C C C C C C C C C C I I I I I I I I I I I I I I I I I I I I I I I I I I I I I I I I I I I I I G G G L L L 
G G G G C C C C C C C C C C C C C C C C C C C C C C I I I I I I I I I I I I I I I I I I I I I I I I I I I I I I I I I I I I I G G G G L L L 
G G G G G C C C C C C C C C C C C C C C C C C C C K I I I I I I I I I I I I I I I I I I I I I I I I I I I I I I I I I I I I G G G G G L L L 
G G G G G G C C C C C C C C C C C K C C C C C C K K K I I I I I I I I I I I I I I I I I I I I I I I I I I I I I I I I I I G G G G G G L L L 
G G G G E E E E E E E X X X K K K K K K K K K K K K K K I I I I I I I I I G I I I I I I I I I I I I I I I I I I I I I I G G G G G G G G L L 
E E E E E E E E E E E X X X K K K K K K K E E K K K K K I I I I I I I G G G G I I I I I I I I I I I I I I I I I I I I G G G G G G D D D L L 
Z E E E E E E E E E X X X X K K K K K K K E E E K K K K K I I I G G G G G G G S X X I I I I I I I I I I I I I I X X N N N N D D D D D D D L 
S S S S E E E E E X X X X X K K K K K K K K E E E K K K K G G G G G G G G G G X X X X X X X X X I X X X X X X X N N N N N D D D D D D D D D 
S S S S X X E E E E X X X K K K K K K K K K K K K K K K K G G G G G G G G G X X X X X X X X X X X X X X X X X N N N N H D D D D D D D D D D 
S S S S X X X E E E E E X K K K K K K K K K K K K K K K K G G G G G G G G X X X X X X X X X X X X X X X X N N N H H H D D D D D D D D D D D 
S S S S S X X X E E E E E E K K K K K K K K K K K K K K K K G G G G G G X X X X X X X X X X X X X X X X N H H H H H D D D D D D D D D D D D 
S S S S S X X X E E E E E E E K K K K K K K K K K K K K K K G G G G X X X X X X X X X X X X X X X X X H H H H H H D D D D D D D D D D D D D 
S S S S X X X X E E E E E E E E K K K K K K K K K K K K K K K G X X X X X X X X X X X X X X X X X X H H H H H H D D D D D D D D D D D D D D 
S S S S X X X L L L L L L L L L L L K K K K K K K K K K K K H X X X X X S S S S X X X X X X X X X X H H H H H H D D D D D D D D D D D D D D 
S S S S X X L R R R R R R R R R R L L X X K K K K K K K K K X X X X X S S S S S S S X X X X X X X H H H H H H D D D D D D D D D D D D D D D 
S S S X X L R R R R R R R R R R R R K K K K X X X K K K K X X X X X S S S S S S S S S X X X X X X H H H H H D D D D D D D D D D D D D D D D 
S S S X R R R R R R R R R R R R R R K K K K K K K K K K B X X X X S S S S S S S S S S S X X X X H H H H H H D D D D D D D D D D D D D D D D 
S S X R R R R R R R R R R R R R R K K K K K K K K K K K K X X X X X S S S S S S S S S S O O O X H H H H H D D D D D D D D D D D D D D D D D 
S X R R R R R R R R R R R R R R K K K K K K K K K K K K K K X X X X S S S S S S S S S O O O O O H H H H D D D D D D D D D D D D D D D D D D 
S R R R R R R R R R R R K K K K K K K K K K K K K K K K K K X X X X X X S S S S S S S O O O O O O H H H D D D D D D D D D D D D D D D D D D 
R R R R R R R R R R K K K K K K K K K K K K K K K K K K K K K X X X X X X S S S S S S O O O O O O O H D D D D D D D D D D D D D D D D D D D 
R R R R R R R R K K K K K K K K K K K K K K K K K K K K K K K X X X X X X X S S S S O O O O O O O O O D D D D D D D D D D D D D D D D D D D 
R R R R R R R K K K K K K K K K K K K K K K K K K K K K K K K K X X X X X X X S S S O O O O O O O O O D D D D D D D D D D D D D D D D D D D 
R R R R R R K K K K K K K K K K K K K K K K K K K K K K K K K K X X X X X X X X S S O O O O O O O O O D D D D D D D D D D D D D D D D D D D 
R R R R R R K K K K K K K K K K K K K K K K K K K K K K K K K K X X X X X X X X X O O O O O O O O O O D D D D D D D D D D D D D D D D D D D 
R R R R R K K K K K K K K K K K K K K K K K K K K K K K K K K K X X X X X X X X X X O O O O O O O O O O D D D D D D D D D D D D D D D D D D 
R R R R K K K K K K K K K K K K K K K K K K K K K K K K K K K K X X X X X X X X X X O O O O O O O O O O D D D D D D D D D D D D D D D D D D 
R R R R K K K K K K K K K K K K K K K K K K K K K K K K K K K K K X X X X X X X X X O O O O O O O O O O D D D D D D D D D D D D D D D D D D 
R R R R K K K K K K K K K K K K K K K K K K K K K K K K K K K K K X X X X X X X X X X O O O O O O O O D D D D D D D D D D D D D D D D D D D 
R R R K K K K K K K K K K K K K K K K K K K K K K K K K K K K K K X X X X X X X X X X O O O O O O O O D D D D D D D D D D D D D D D D D D D 
R R L K K K K K K K K K K K K K K K K K K K K K K K K K K K K K K X X X X X X X X X X X O O O O O O O D D D D D D D D D D D D D D D D D D D 
R L L K K K K K K K K K K K K K K K K K K K K K K K K K K K K K B X X X X X X X X X X X O O O O O O O D D D D D D D D D D D D D D D D D D D 
B B B K K K K K K K K K K K K K K K K K K K K K K R R R R R R B B X X X X X X X X X X X X O O O O O D D D D D D D D D D D D D D D D D D D D 
B B B B K K K K K K K K K K K K K K K K K K K K R R R R R R R B B B X X X X X X X X X X X O O O O D D D O D D D D D D D D D D D D D D D D D 
B B B B B K K K K K K K K K K K K K K K K K K R R R R R R R R R B B X X X X X X X X X X X D D D D D D O O O D D D D D D D D D D D D D D D O 
B B B B B B B K K K K K K K K K K K K K K K R R R R R R R R R R B B X X X X X X X X X X X D D D D D O O O O O O D D D D D D D D D D D D O O 
B B B B B B B B K K K K K K K K K K K K K R R R R R R R R R R R R B D X X X X X X X X X D D D D D D O O O O O O O D D D D D D D D D D O O O 
B B B B B B B B B Q K K K K K K K K K R R R R R R R R R R R R R R D D D X X X X X X D D D D D D D D O O O O O O O O O O O O O O O O O O O O 
B B B B B B B B B Q Q Q Q Q K K R R R R R R R R R R R R R R R R R D D D D D D D D D D D D D D D D O O O O O O O O O O O O O O O O O O O O O 
H H H H H B B B B B Q Q Q Q R R R R R R R R R R R R R R R R R R D D D D D D D D D D D D D D D D O O O O O O O O O O O O O O O O O O O O O O 
H H H H H H H H H B Q Q Q Q R R R R R R R R R R R R R R R R R D D D D D D D D D D D D D D D O O O O O O O O O O O O O O O O O O O O O O O U 
H H H H H H H H H H H Q Q Q R R R R R R R R R R R R R R R U U U U D D D D H D D D D D D D D O O O O O O O O O O O O O O O O O O V V V V V V 
H H H H H H H H H H H H H Q R R R R R R R R R R R R U U U U U U U U U D D U U D D D D D D O O O O O N N N N N N O O O O V V V V V V V V V V 
H H H H H H H H H H H H H H H R R R R R R R R D D U U U U U U U U U U U U U U U D D D D D O O O N N N N N N N N N N V V V V V V V V V V V V 
H H H H H H H H H H H H H H H H D D D D D D D D U U U U U U U U U U U U U U U U U U D H H N N N N N N N N N N N N V V V V V V V V V V V V V 
H H H H H H H H H H H H H H H H D D D D D D D D U U U U U U U U U U U U U U U U U U H H H N N N N N N N N N N N V V V V V V V V V V V V V V 
H H H H H H H H H H H H H H H H H D D D D D D U U U U U U U U U U U U U U U U U U U H H N N N N N N N N N N N V V V V V V V V V V V V V V V 
H H H H H H H H H H H H H H H H H D D D D D U U U U U U U U U U U U U U U U U U U U H H N N N N N N N N N N V V V V V V V V V V V V V V V V 
H H H H H H H H H H H H H H H H H H D D D D U U U U U U U U U U U U U U U U U U U N N N N N N N N N N N N V V V V V V V V V V V V V V V V V 
H H H H H H H H H H H H H H H H H H D D D D U U U U U U U U U U U U U U A A A H N N N N N N N N N N N N V V V V V V V V V V V V V V V V V V 
H H H H H H H H H H H H H H H H H H H D D D U U U U U U U U U U U U A A A A A H H N N N N N N N N N N N V V V V V V V V V V V V V V V V V V 
H H H H H H H H H H H H H H H H H H H D D U U U U U U U U U U A A A A A A A A H H N N N N N N N N N N V V V V V V V V V V V V V V V V V V V 
L L H H H H H H H H H H H H H H H H H H D U U U U U U U U A A A A A A A A A A H H N N N N N N N N N N V V V V V V V V V V V V V V V V V V V 
L L L L H H H H H H H H H H H H H H H H D U U U U U A A A A A A A A A A A A A A H N N N N N N N N N N V V V V V V V V V V V V V V V V V V V 
L L L L L L H H H H H H H H H H H H H H H U U U U A A A A A A A A A A A A A A A H N N N N N N N N N N V V V V V V V V V V V V V V V V V V V 
L L L L L L H H H H H H H H H H H H H H H U U A A A A A U U A A A A A A A A A A H N N N N N N N N N N N V V V V V V V V V V V V V V V V V V 
L L L L L L L H H H H H H H H H H H H H H H A A A U U U U U U U U Y Y Y Y Y Y A H N N N N N N N N N N N V V V V V V V V V V V V V V V V V V 
L L L L L L L H H H H H H H H H H H H H H H H A U U U U U U U Y Y Y Y Y Y Y Y Y Y N N N N N N N N N N N V V V V V V V V V V V V V V V V V V 
L L L L L L L H H H H H H H H H H H H H H H H U U U U U U U Y Y Y Y Y Y Y Y Y Y Y Y N N N N N N N N N N V V V V V V V V V V V V V V V V V V 
L L L L L L L H H H H H H H H H H H H H H H H U U U U U U Y Y Y Y Y Y Y Y Y Y Y Y Y N N N N N N N N N N N V V V V V V V V V V V V V V V V V 
L L L L L L L H H H H H H H H H H H H H H H H U U U U U Y Y Y Y Y Y Y Y Y Y Y Y Y Y Y N N N N N N N N N N V V V V V V V V V V V V V V V V V 
L L L L L L L H H H H H H H H H H H H H H H H U U U U Y Y Y Y Y Y Y Y Y Y Y Y Y Y Y Y Y N N N N N N N N N V V V V V V V V V V V V V V V V V 
L L L L L L H H H H H H H H H H H H H H H H H U U U U Y Y Y Y Y Y Y Y Y Y Y Y Y Y Y Y Y N N N N N N N N N N V V V V V V V V V V V V V V V V 
L L L L L L H H H H H H H H H H H H H H H H H U U U U Y Y Y Y Y Y Y Y Y Y Y Y Y Y Y Y Y N N N N N N N N N N V V V V V V V V V V V V V V V V 
L L L L L H H H H H H H H H H H H H H H H H H U U U Y Y Y Y Y Y Y Y Y Y Y Y Y Y Y Y Y Y Y N N N N N N N N N V V V V V V W V V V V V V V V V 
L L L H H H H H H H H H H H H H H H H H H H H U U U Y Y Y Y Y Y Y Y Y Y Y Y Y Y Y Y Y Y Y N N N N N N N N N N V V V V W W W W V V V V V V V 
