D D D D D D D D D D D D D D D D D D D D D D D D D D D D D D D D D D B B B B B B B B B B R R Q K K K K K K K K K K K K K K K K K K K K K K K K K K X X R R R R R R Q Q Q Q Q Q Q Q Q Q G G L L L L L L L 
D D D D D D D D D D D D D D D D D D D D D D D D D D D D D D D D D D B B B B B B B B B R R Q Q K K K K K K K K K K K K K K K K K K K K K K K K K K X X X R R R R R R R X X X X X X Q Q G G G G L L L L L 
D D D D D D D D D D D D D D D D D D D D D D D D D D D D D D D D D D B B B B B B B B B R Q Q Q K K K K K K K K K K K K K K K K K K K K K K K K K K K X X R R R R R R R X X X X X X X X X G G G G L L L L 
D D D D D D D D D D D D D D D D D D D D D D D D D D D D D D D D D D B B B B B B B B B Q Q Q Q Q K K K K K K K K K K K K K K K K K K K K K K K K K K X X X R R R R R X X X X X X X X X X X G G G G G L L 
D D D D D D D D D D D D D D D D D D D D D D D D D D D D D D D D D D B B B B B B B B Q Q Q Q Q Q K K K K K K K K K K K K K K K K K K K K K K K K K K X X X X R R R R X X X X X X X X X X X X G G G G G L 
D D D D D D D D D D D D D D D D D D D D D D D D D D D D D D D D D B B B B B B B B Q Q Q Q Q Q Q Q K K K K K K K K K K K K K K K K K K K K K K K K X X X X X X R R R X X X X X X X X X X X X X G G G G G 
D D D D D D D D D D D D D D D D D D D D D D D D D D D D D D D D D B B B B B B B B Q Q Q Q Q Q Q Q Q K K K K K K K K K K K K K K K K K K K K K K K X X X X X X R R R X X X X X X X X X X X X X X G G G G 
D D D D D D D D D D D D D D D D D D D D D D D D D D D D D D D D D B B B B B B B Q Q Q Q Q Q Q Q Q Q Q K K K K K K K K K K K K K K K K K K K K K K X X X X X X X R R X X X X X X X X X X X X X X G G G G 
D D D D D D D D D D D D D D D D D D D D D D D D D D D D D D D D D B B B B B B B Q Q Q Q Q Q Q Q Q Q Q Q Q Q K K K K K K K K K K K K K K K K K K X X X X X X X X X R X X X X X X X X X X X X X X X G G G 
D D D D D D D D D D D D D D D D D D D D D D D D D D D D D D D D B B B B B B B Q Q Q Q Q Q Q Q Q Q Q Q Q Q Q Q Q Q Q Q K K K K K K K K K K K K K X X X X X X X X X X R X X X X X X X X X X X X X X X G G 
D D D D D D D D D D D D D D D D D D D D D D D D D D D D D D D D B B B B B B Q Q Q Q Q Q Q Q Q Q Q Q Q Q Q Q Q Q Q Q Q Q Q Q Q Q Q K K K K K K X X X X X X X X X X X R X X X X X X X X X X X X X X X X G 
D D D D D D D D D D D D D D D D D D D D D D D D D D D D D D D D B B B B B B Q Q Q Q Q Q Q Q Q Q Q Q Q Q Q Q Q Q Q Q Q Q Q Q Q Q Q Q Q Q Q X X X X X X X X X X X X X X X X X X X X X X S S S X X X X X G 
D D D D D D D D D D D D D D D D D D D D D D D D D D D D D D D D B B B B B Q Q Q Q Q Q Q Q Q Q Q Q Q Q Q Q Q Q Q Q Q Q Q Q Q Q Q Q Q Q Q Q X X X X X X X X X X X X X X X X X X X X X X S S S S X X X X X 
D D D D D D D D D D D D D D D D D D D D D D D D D D D D D D D B B B B B B Q Q Q Q Q Q Q Q Q Q Q Q Q Q Q Q Q Q Q Q Q Q Q Q Q Q Q Q Q Q Q Q X X X X X X X X X X X X X X X X X X X X X X S S S S S X X X X 
D D D D D D D D D D D D D D D D D D D D D D D D D D D D D D D B B B B O Q Q Q Q Q Q Q Q Q Q Q Q Q Q Q Q Q Q Q Q Q Q Q Q Q Q Q Q Q Q Q Q X X X X X X X X X X X X X X X X X X X X X X X S S S S S S X X X 
D D D D D D D D D D D D D D D D D D D D D D D D D D D D D D D B B B O O Q Q Q Q Q Q Q Q Q Q Q Q Q Q Q Q Q Q Q Q Q Q Q Q Q Q Q Q Q Q Q Q X X X X X X X X X X X X X X X X X X X X X X S S S S S S S S X X 
D D D D D D D D D D D D D D D D D D D D D D D D D D D D D D B B B O O H H H H H H H H H H H H H H H H H H H H H H H H Q Q Q Q Q Q Q Q Q X X X X X X X X X X X X X X X X X X X X X X X S S S S S S S X X 
D D D D D D D D D D D D D D D D D D D D D D D D D D D D D D B B O O H H H H H H H H H H H H H H H H H H H H H H H H H H H H H H H H Q X X X X X X X X X X X X X X X X X X X X X X X X S S S S S S X X X 
D D D D D D D D D D D D D D D D D D D D D D D D D D D D D D B O O H H H H H H H H H H H H H H H H H H H H H H H K K K H H H H H H H H H X X X X X X X X X X X X X X X X X X X X X X X S S S S S S X X X 
D D D D D D D D D D D D D D D D D D D D D D D D D D D D H H J J H H H H H H H H H H H H H H H H H H H H H K K K K K K K K H H H H H H H H X X X X X X X X X X X X X X X X X X X X X X X S S S S X X X X 
D D D D D N D D D D D D D D D D D D D D D D D D D D D H H H J H H H H H H H H H H H H H H H H H H H H H K K K K K K K K K K K H H H H H H H X X X X X X X X X X X X X X X X X X X X X X S S S S X X X X 
D D D D N N N N N D D D D D D D D D D D D D D D D D H H H J H H H H H H H H H H H H H H H H H H H H H K L L L L L L L L L L K K H H H H H H H X X X X X X X X X X X X X X X X X X X X X S S S S X X X X 
D D D D N N N N D D D D D D D D D D D D D D D D D H H H H J H H H H H H H H H H H H H H H H H H H L L L L L L L L L L L L L L L L H H H H H H H X X X X X X X X X X X X X X X X X X X X X S S S X X X X 
D D D D N N D D D D D D D D D D D D D D D D D H H H H H J H H H H H H H H H H H H H H H H H H H L L L L L L L L L L L L L L L L L L H H H H H H H X X X X X X X X X X X X X X X X X X X X X X X X X X X 
D D D D D D D D D D D D D D D D D D D D D H H H H H H H H H H H H H H H H H H H H H H H H H H L L L L L L L L L L L L L L L L L L L L L H H H H H H X X X X X X X X X X X X X X X X X X X X X X X X X X 
D D D D D D D D D D D D D D D D D D H H H H H H H H H J H H H H H H H H H H H H H H H H H H L L L L L L L L L L L L L L L L L L L L L L L H H H H H X X X X X X X X X X X X X X X X X X X X X X X X X X 
O D D D D D D D D D D D D D D D D H H H H H H H H H H H H H H H H H H H H H H H H H H H H L L L L L L L L L L L L L L L L L L L L L L L L L H H H H H X X X X X X X X X X X X X X X X X X X X X X X X X 
O O D D D D D D D D D D D D D D D H H H H H H H H H J H H H H H H H H H H H H H H H H H L L L L L L L L L L L L L L L L L L L L L L L L L L L H H H H H X X X X X X X X X X X X X X X X X X X X X X X E 
O O H D D D D D D D D D D D D D D H H H H H H H H H H H H H H H H H H H H H H H H H H L L L L L L L L L L L L L L L L L L L L L L L L L L L L H H H H H X X X X X X X X X X X X X X X X X X X X X X X E 
O X X X D D D D D D D D D D D D H H H H H H H H H J H H H H H H H H H H H H H H H H H L L L L L L L L L L L L L L L L L L L L L L L L L L L L L H H H H H X X X X X X X X X X X X X X X X X X X X X E E 
X X X X X X D D D D D D D D D D H H H H H H H H H H H H H H H H H H H H H H H H H H L L L L L L L L L L L L L L L L L L L L L L L L L L L L L L H H H H H X X X X X X X X X X X X X X X X X X X X E E G 
X X X X X X X D D D D D D D D D H H H H H H H H P H H H H H H H H H H H H H H H H H L L L L L L L L L L L L L L L L L L L L L L L L L L L L L L L H H H H H X X X X X X X X X X X X X X X X X X X E G G 
X X X X X X X X D D D D D D D D H H H H H H H P H H H H H H H H H H H H H H H H H L L L L L L L L L L L L L L L L L L L L L L L L L L L L L L L L H H H H H X X X X X X X X X X X X X X X X X X E G G G 
X X X X X X X X X X D D D D D D H H H H H P P P H H H H H H H H H H H H H H H H H L L L L L L L L L L L L L L L L L L L L L L L L L L L L L L L L L H H H H B X X X X X X X X X X X X X X X X X G G G G 
X X X X X X X X X X X X X X X X X X P P P P P P H H H H H H H H H H H H H H H H H L L L L L L L L L L L L L L L L L L L L L L L L L L L L L L L L L H H H H H B X X X X X X X X X X X X X X X G G G G G 
X X X X X X X X X X X X X X X X X X X P P P P P H H H H H H H H H H H H H H H H H L L L L L L L L L L L L L L L L L L L L L L L L L L L L L L L L L H H H H H B B E E X X X X X X X X X X X X G G G G G 
X X X X X X X X X X X X X X X X X X X P P P P H H H H H H H H H H H H H H H H H H L L L L L L L L L L L L L L L L L L L L L L L L L L L L L L L L L H H H H H B B E E E X X X X X X X X X E G G G G G G 
X X X X X X X X X X X X X X X X X X X X P P P H H H H H H H H H H H H H H H H H L L L L L L L L L L L L L L L L L L L L L L L L L L L L L L L L L L H H H H H B B K K E E X X X X X X X E G G G G G G G 
X X X X X X X X X X X X X X X X X X X X X P P H H H H H H H H H H H H H H H H H L L L L L L L L L L L L L L L L L L L L L L L L L L L L L L L L L L H H H H H H K K K K K K E X X K K E E G G G G G G G 
X X X X X X X X X X X X X X X X X X X X X X P H H H H H H H H H H H H H H H H H L L L L L L L L L L L L L L L L L L L L L L L L L L L L L L L L L L H H H H H H K K K K K K K K K K K E E G G G G G C C 
X X X X X X X X X X X X X X X X X X X X X X X H H H H H H H H H H H H H H H H H H L L L L L L L L L L L L L L L L L L L L L L L L L L L L L L L L L H H H H H H K K K K K K K K K K K K G G G G G C C C 
X X X X X X X X X X X X X X X X X X X X X X X B H H H H H H H H H H H H H H H H H L L L L L L L L L L L L L L L L L L L L L L L L L L L L L L L L L H H H H H H K K K K K K K K K K K K G G G C C C C C 
X X X X X X X X X X X X X X X X X X X X X X X B H H H H H H H H H H H H H H H H H L L L L L L L L L L L L L L L L L L L L L L L L L L L L L L L L H H H H H H K K K K K K K K K K K K K G C C C C C C C 
X X X X X X X X X X X X X X X X X X X X X X X B B H H H H H H H H H H H H H H H H L L L L L L L L L L L L L L L L L L L L L L L L L L L L L L L L H H H H H H K K K K K K K K K K K K K C C C C C C C C 
X X X X X X X X X X X X X X X X X X X X X X X B B B H H H H H H H H H H H H H H H H L L L L L L L L L L L L L L L L L L L L L L L L L L L L L L H H H H H H H K K K K K K K K K K K K C C C C C C C C C 
X X X X X X X X X X X X X X X X X X X X X X D B B B H H H H H H H H H H H H H H H H L L L L L L L L L L L L L L L L L L L L L L L L L L L L L L H H H H H H H K K K K K K K K K K K K C C C C C C C C C 
X X X X X X X X X X X X X X X X X X X X X X D B B B B H H H H H H H H H H H H H H H H L L L L L L L L L L L L L L L L L L L L L L L L L L L L H H H H H H H K K K K K K K K K K K K K C C C C C C C C C 
X X X X X X X X X X X X X X X X X X X X X X D D B B B B H H H H H H H H H H H H H H H H L L L L L L L L L L L L L L L L L L L L L L L L L L H H H H H H H H K K K K K K K K K K K K C C C C C C C C C C 
O O O O X X X X X X X X X X X X X X X X X X D D D B B B B H H H H H H H H H H H H H H H L L L L L L L L L L L L L L L L L L L L L L L L H H H H H H H H H H K K K K K K K K K K K K C C C C C C C C C C 
O O O O O O O X X X X X X X X X X X X X X X D D D B B B B B H H H H H H H H H H H H H H H H L L L L L L L L L L L L L L L L L L L L L H H H H H H H H H H H K K K K K K K K K K K K C C C C C C C C C C 
O O O O O O O O O X X X X X X X X X X X X S S S S S S B B B H H H H H H H H H H H H H H H H H L L L L L L L L L L L L L L L L L L H H H H H H H H H H H H K K K K K K K K K K K K C C C C C C C C C C C 
O O O O O O O O O X X X X X X X X X X X S S S S S S S S S B B H H H H H H H H H H H H H H H H H H L L L L L L L L L L L L L H H H H H H H H H H H H H H H K K K K K K K K K K K K C C C C C C C C C C C 
O O O O O O O O O O X X X X X X X X X S S S S S S S S S S S B B H H H H H H H H H H H H H H H H H H H H H H L L L H H H H H H H H H H H H H H H H H H H H K K K K K K K K K K K K C C C C C C C C C C C 
O O O O O O O O O O O O O O O O O L L L L L S S S S S S S S S S B H H H H H H H H H H H H H H H H H H H H H H H H H H H H H H H H H H H H H H H H H H H S K K K K K K K K K K K K C C C C C C C C C C C 
O O O O O O O O O O O O O O O O L L L L L L L L S S S S S S S S S B H H H H H H H H H H H H H H H H H H H H H H H H H H H H H H H H H H H H H H H H H H S K K K K K K K K K K K K C C C C C C C C C C C 
O O O O O O O O O O O O O O L L L L L L L L L L L L S S S S S S S S S H H H H H H H H H H H H H H H H H H H H H H H H H H H H H H H H H H H H H H H H S S K K K K K K K K K K K K C C C C C C C C C C C 
O O O O O O O O O O O O O L L L L L L L L L L L L L L L S S S S S S S S H H H H H H H H H H H H H H H H H H H H H H H H H H H H H H H H H H H H H H S S S K K K K K K K K K K K K K C C C C C C C C C C 
O O O O O O O O O O O O L L L L L L L L L L L L L L L L L S S S S S S S S S H H H H H H H H H H H H H H H H H H H H H H H H H H H H H H H H H H S S S S S K K K K K K K K K K K K K C C C C C C C C C C 
O O O O O O O O O O O L L L L L L L L L L L L L L L L L L L S S S S S S S S S H H H H H H H H H H H H H H H H H H H H H H H H H H H H H H H H S S K K K K K K K K K K K K K K K K K E E C C C C C C C C 
O O O O O O O O O O L L L L L L L L L L L L L L L L L L L L L S S S S S S S S S S H H H H H H H H H H H H H H H H H H H H H H H H H H H H S K K K K K K K K K K K K K K K K K K K K K E E E C C C C C C 
G G G G O O O O O L L L L L L L L L L L L L L L L L L L L L L L S S S S S S S S S S H H H H H H H H H H H H H H H H H H H H H H H H H S K K K K K K K K K K K K K K K K K K K K K K K K E E E U U U U U 
G G G G G G S O O L L L L L L L L L L L L L L L L L L L L L L L S S S S S S S S S S S S H H H H H H H H H H H H H H H H H E E E E E E K K K K K H H H H H H H H K K K K K K K K K K U U U U U U U U U U 
G G G G G G S O L L L L L L L L L L L L L L L L L L L L L L L L L S S S S S S S S S S S E E E E E E E E E E E E E E E E E E E E E K K H H H H H H H H H H H H H H H H K K K K K K U U U U U U U U U U U 
G G G G G G S S L L L L L L L L L L L L L L L L L L L L L L L L L S S S S S S S S S S S E E E E E E E E E E E E E E E E E K K K K K H H H H H H H H H H H H H H H H H H K K K K U U U U U U U U U U U U 
G G G G G G S S L L L L L L L L L L L L L L L L L L L L L L L L L L S S S S S S S S S S E E E E E E E E E E E E E K K K K K K K H H H H H H H H H H H H H H H H H H H H K K K K U U U U U U U U U U U U 
G G G G G G S S L L L L L L L L L L L L L L L L L L L L L L L L L S S S S S S S S S S S S E E E E E E E H H H H H H H H H H H H H H H H H H H H H H H H H H H H H H H H H K K U U U U U U U U U U U U U 
G G G G G G S S L L L L L L L L L L L L L L L L L L L L L L L L S S S S S S S S S S S S S S H H H H H H H H H H H H H H H H H H H H H H H H H H H H H H H H H H H H H H H K U U U U U U U U U U U U U U 
G G G G G G G S L L L L L L L L L L L L L L L L L L L L L L L S S S S S S S S S S S S S S S H H H H H H H H H H H H H H H H H H H H H H H H H H H H H H H H H H H H H H H H U U U U U U U U U U U U U U 
G G G G G G G S L L L L L L L L L L L L L L L L L L L L L L S S S S S S S S S S S S S S S S H H H H H H H H H H H H H H H H H H H H H H H H H H H H H H H H H H H H H H H U U U U U U U U U Y Y Y Y Y Y 
G G G G G G G S S L L L L L L L L L L L L L L L L L L L L S S S S S S S S S S S S S S S S S H H H H H H H H H H H H H H H H H H N N N N H H H H H H H H H H H H H H H H H U U U U U Y Y Y Y Y Y Y Y Y Y 
G G G G G G G S S L L L L L L L L L L L L L L L L L L J S S S S S S S S S S S S S S S S S H H H H H H H H H H H H H H H H H H N N N N N N N N H H H H H H H H H H H H H H U U X Y Y Y Y Y Y Y Y Y Y Y Y 
G G G G G G G G S S L L L L L L L L L L L L L L L S J J S S S S S S S S S S S S S S S S H H H H H H H H H H H H N N N N N N N N N N N N N N N N N N N H H H H H H H H H X X X Y Y Y Y Y Y Y Y Y Y Y Y Y 
G G G G G G G G S S L L L L L L L L L L L L L S J J J S S S S S S S S S S S S S S S S H H H H H H H H N N N N N N N N N N N N N N N N N N N N N N N N N N N H H H H H X X X Y Y Y Y Y Y Y Y Y Y Y Y Y Y 
G G G G G G G G S S S L L L L L L L L L L L J J J J S S S S S S S S S S S S S S S H H H H H H N N N N N N N N N N N N N N N N N N N N N N N N N N N N N N N N H H H H X X Y Y Y Y Y Y Y Y Y Y Y Y Y Y Y 
G G G G G G G G G S S S S L L L L L L L J J J J S S S S S S S S S S S S S S S S H H H N N N N N N N N N N N N N N N N N N N N N N N N N N N N N N N N N N N N N N H Y Y Y Y Y Y Y Y Y Y Y Y Y Y Y Y Y Y 
G G G G G G G G G S S S S S S L L L L J J J S S S S S S S S S S S S S G G G G G N N N N N N N N N N N N N N N N N N N N N N N N N N N N N N N N N N N N N N N N N Y Y Y Y Y Y Y Y Y Y Y Y Y Y Y Y Y Y Y 
G G G G G G G G G G S S S S S S S S S S S S S S S S S S S S S G G G G G G G G N N N N N N N N N N N N N N N N N N N N N N N N N N N N N N N N N N N N N N N N N N Y Y Y Y Y Y Y Y Y Y Y Y Y Y Y Y Y Y Y 
G G G G G G G G G G S S S S S S S S S S S S S S S S S S S G G G G G G G G G N N N N N N N N N N N N N N N N N N N N N N N N N N N N N N N N N N N N N N N N N N Y Y Y Y Y Y Y Y Y Y Y Y Y Y Y Y Y Y Y Y 
G G G G G G G G G G G S S S S S S S S S S S S S S S S G G G G G G G G G G N N N N N N N N N N N N N N N N N N N N N N N N N N N N N N N N N N N N N N N N N N N Y Y Y Y Y Y Y Y Y Y Y Y Y Y Y Y Y Y Y Y 
G G G G G G G G G G G S S S S S S S S S S S S S S G G G G G G G G G G G G N N N N N N N N N N N N N N N N N V V V V V V V V N N N N N N N N N N N N N N N N N N Y Y Y Y Y Y Y Y Y Y Y Y Y Y Y Y Y Y Y Y 
G G G G G G G G G G G G S S S S S S S S S S S S G G G G G G G G G G G G N N N N N N N N N N N V V V V V V V V V V V V V V V V V V N N N N N N N N N N N N N N N Y Y Y Y Y Y Y Y Y Y Y Y Y Y Y Y Y Y Y Y 
G G G G G G G G G G G G S S S S S S S S S S G G G G G G G G G G G G G N N N H H H N V V V V V V V V V V V V V V V V V V V V V V V V V N N N N N N N N N N N N N Y Y Y Y Y Y Y Y Y Y Y Y Y Y Y Y Y Y Y Y 
G G G G G G G G G G G G G S S S S S S S S G G G G G G G G G G G G G H H H H H H V V V V V V V V V V V V V V V V V V V V V V V V V V V V N N N N N N N N N N N N Y Y Y Y Y Y Y Y Y Y Y Y Y Y Y Y Y Y Y Y 
G G G G G G G G G G G G G S S S S S S S S G G G G G G G G G G G G H H H H H H V V V V V V V V V V V V V V V V V V V V V V V V V V V V V V V V V N N N N N N N N Y Y Y Y Y Y Y Y Y Y Y Y Y Y Y Y Y Y Y Y 
G G G G G G G G G G G G G S S S S S S S G G G G G G G G G G G G H H H H H V V V V V V V V V V V V V V V V V V V V V V V V V V V V V V V V V V V V V N N N N N N Y Y Y Y Y Y Y Y Y Y Y Y Y Y Y Y Y Y Y Y 
G G G G G G G G G G G G G G S S S S S S G G G G G G G G G G G H H H H H V V V V V V V V V V V V V V V V V V V V V V V V V V V V V V V V V V V V V V V N N N N N Y Y Y Y Y Y Y Y Y Y Y Y Y Y Y Y Y Y Y Y 
G G G G G G G G G G G G G G S S S S S G G G G G G G G G G H H H H H H V V V V V V V V V V V V V V V V V V V V V V V V V V V V V V V V V V V V V V V V V N N N N Y Y Y Y Y Y Y Y Y Y Y Y Y Y Y Y Y Y Y Y 
G G G G G G G G G G G G G G S S S S S G G G G G G G G G G H H H H H V V V V V V V V V V V V V V V V V V V V V V V V V V V V V V V V V V V V V V V V V V N N N N Y Y Y Y Y Y Y Y Y Y Y Y Y Y Y Y Y Y Y Y 
G G G G G G G G G G G G G G S S S S S G G G G G G G G G H H H H H V V V V V V V V V V V V V V V V V V V V V V V V V V V V V V V V V V V V V V V V V V V V N N N N Y Y Y Y Y Y Y Y Y Y Y Y Y Y Y Y Y Y Y 
G G G G G G G G G G G G G X X X X X X X X X G G G G G H H H H H V V V V V V V V V V V V V V V V V V V V V V V V V V V V V V V V V V V V V V V V V V V V V V N N N Y Y Y Y Y Y Y Y Y Y Y Y Y Y Y Y Y Y Y 
G G G G G G G G G G G G G X X X X X X X X X X G G G H H H H H V V V V V V V V V V V V V V V V V V V V V V V V V V V V V V V V V V V V V V V V V V V V V V V V N N Y Y Y Y Y Y Y Y Y Y Y Y Y Y Y Y Y Y Y 
G G G G G G G G G G S G X X X X X X X X X X X X G H H H H H V V V V V V V V V V V V V V V V V V V V V V V V V V V V V V V V V V V V V V V V V V V V V V V V V N N Y Y Y Y Y Y Y Y Y Y Y Y Y Y Y Y Y Y Y 
G G G G G G G G G S S S X X X X X X X X X X X X H H H H H H V V V V V V V V V V V V V V V V V V V V V V V V V V V V V V V V V V V V V V V V V V V V V V V V V V N N Y Y Y Y Y Y Y Y Y Y Y Y Y Y Y Y Y Y 
G G I I I I G G G S S S X X X X X X X X X X X X H H H H H V V V V V V V V V V V V V V V V V V V V V V V V V V V V V V V V V V V V V V V V V V V V V V V V V V V N N Y Y Y Y Y Y Y Y Y Y Y Y Y Y Y Y Y Y 
G I I I I I I G S S S S X X X X X X X X X X X H H H H H V V V V V V V V V V V V V V V V V V V V V V V V V V V V V V V V V V V V V V V V V V V V V V V V V V V V V N N Y Y Y Y Y Y Y Y Y Y Y Y Y Y Y Y Y 
I I I I I I I I S S S S X X X X X X X X X X X H H H H H V V V V V V V V V V V V V V V V V V V V V V V V V V V V V V V V V V V V V V V V V V V V V V V V V V V V V V N Y Y Y Y Y Y Y Y Y Y Y Y Y Y Y Y Y 
I I I I I I I I E S S S X X X X X X X X X X X H H H H H V V V V V V V V V V V V V V V V V V V V V V V V V V V V V V V V V V V V V V V V V V V V V V V V V V V V V V N N Y Y Y Y Y Y Y Y Y Y Y Y Y Y Y Y 
I I I I I I I I I I I I I I X X X X X X X X X H H H H V V V V V V V V V V V V V V V V V V V V V V V V V V V V V V V V V V V V V V V V V V V V V V V V V V V V V V V V N Y Y Y Y Y Y Y Y Y Y Y Y Y Y Y Y 
I I I I I I I I I I I I I I I I X X X X X X X H H H H V V V V V V V V V V V V V V V V V V V V V V V V V V V V V V V V V V V V V V V V V V V V V V V V V V V V V V V V N N Y Y Y Y Y Y Y Y Y Y Y Y Y Y Y 
I I I I I I I I I I I I I I I I I I I X X X X H H H H V V V V V V V V V V V V V V V V V V V V V V V V V V V V V V V V V V V V V V V V V V V V V V V V V V V V V V V V V N Y Y Y Y Y Y Y Y Y Y Y Y Y Y Y 
