D D D D D D D O O O O O O O O O O O O O H H H H H H H H N N N N N N W W V V V V V V V V V V V V V V 
D D D D D D D D O O O O O O O O O O O O O H H H H H H H N N N N N N W W V V V V V V V V V V V V V V 
D D D D D D D D D O O O O O O O O O O O O O S H H H H H N N N N N W W V V V V V V V V V V V V V V V 
D D D D D D D D D D O O O O O O O O O O O O O S S H H H N N N N N W W V V V V V V V V V V V V V V V 
D D D D D D D D D D O O O O O O O S O O O O O S S S H H N N N N N W W V V V V V V V V V V V V V V V 
D D D D D D D D D D O O O O O O S S O O O O O O S S S G G N N N N W W W V V V V V V V V V V V V V V 
D D D D D D D D D D H O O O O O S S O O O O O O S S S G G N N N N W W W V V V V V V V V V V V V V V 
D D D D D D D D D H H H O O O S S S O O O O O O S S S G G N N N N W W W V V V V V V V V V V V V V V 
D D D D D D D D D H H H B O S S S S S O O O O O S S S G G N N N N W W W W V V V V V V V V V V V V V 
D D D D D D D D H H H H H S S S S S S O O O O S S S S G G N N N N W W W W V V V V V V V V V V V V V 
D D D D D D D D H H H H H S S S S S S S S O S S S S S G G N N N N W W W W W V V V V V V V V V V V V 
D D D D D D D D H H H H H S S S S S S S S S S S S S S G O N N N N W W W W W V V V V V V V V V V V V 
D D D D D D D H H H H H H S S S S S S S S S S S S S S O O N N N N N W W W W W V V V V V V V V V V V 
D D D D D D D H H H B B R S S S S S S S S S S S S S G O O N N N N N W W W W W W W V V V V V V V V V 
D D D D D D H B B B B R R R S S S S S S X S S S S S O O O N N N N N W W W W W W W W V V V V V V V V 
D D D D B B B B B B R R R R X X S S S S X X X X X X O O O N N N N N N W W W W W W W W V V V V V V V 
B B B B B B B B B R R R X X X X X X S S X X X X X X O O O O N N N N N W W W W W W W V V V V V V V V 
B B B B B B B B B B R X X X X X X X X X X X X X X X G O O O N N N N N N W W W W W V V V V V V V V V 
B B B B B B B B S S S S S X X X X X X X X X X X X X G G O O N N N N N N N W W W W N N N N N N V V V 
B B B B B B S S S S S S S S X X X X X X X K K K X G G G O O N N N N N N N N N N N N N N N N N N V V 
B B B B B S S S S S S S S S S X X X X X X K K K K G G G G O H N N N N N N N N N N N N N N N N N N N 
B B B S S S S S S S S S S S S X X X X X X K K K K K G G G G H H N N N N N N N N N N N N N N N N N N 
X S S S S S S S S S S S S S S X X X X X X K K K K K K K G G H H H N N N N N N N N N N N N N N N N N 
X S S S S S S S S S S S S S S X X X X X E K K K K K K K K G K K H H N N N N N N N N N N N N N N N N 
S S S S S S S S S S S S S S S X X X X X E E K K K K K K K K K K K H N N N N N N N N N N N N N N Y Y 
S S S S S S S S S S S S S S S X X X X E E E E K K K K K K K T K K K H N N N N N N N N N N N Y Y Y Y 
S S S S S S S S S S S S S S X X X X E E E E E K K K K K K K T T K K H H N N N N N N N N Y Y Y Y Y Y 
X S S S S S S S S S S S S X X X X E E E E E K K K K K K K K T T T H H H H H H N N N N Y Y Y Y Y Y Y 
X X S S S S S S S S S S X X X X E E E E E E K K K K K K K K K T T T H H H H H H H H X Y Y Y Y Y Y Y 
X X S S S S S S S S S X X X X E E E E E E K K K K K K K K K K T T T T H H H H H H H Y Y Y Y Y Y Y Y 
X X X S S S S S S X X X X X X E E E E E R K K L L L L L K K T T T T T H H H H H H H Y Y Y Y Y Y Y Y 
X X X X X S S S X X X X X X E E E E E R R R L L L L L L L T T T T T T T H H H H H H H Y Y Y Y Y Y Y 
E E E X X X X X X X X X X E E E E E R R R L K K K K K K X X T T T T T T T H H H H H H Y Y Y Y Y Y Y 
E E E E E E X X X X X X E E E E E R R R L K K K K K K K K X X T T T T T T H H H K K K K Y Y Y Y Y Y 
E E E E E E E X X X X K K E E E E R R L K K K K K K K K K K X X T T T T H H H K K K K K K Y Y Y Y Y 
E E E E E E E E X K K K K K E E R R R K K K K K K K K K K K X X X H H H H H H K K K K K K K Y Y Y Y 
C E E E E E E E K K K K K K E E R R K K K K K K K K K K K K Q X H H H H H H H H K K K K K K K Y Y Y 
C C C E E E E E K K K K K K E E R K K K K K K K K K K K K Q Q Q H H H H H H H H H K K K K K K K K Y 
C C C C C E E E K K K K K K K T T K K K K K K K K K K K Q Q Q H H H H H H H H H H H K K K K K K K K 
C C C C C C E E K K K K K K K T K K K K K K K K K K K K Q Q Q H H H H H H H H H H H H H K K K K K K 
C C C C C C C G K K K K K K R T K K K K K K K K K K K Q Q Q H H H H H H H H H H H H H H H K K K K K 
C C C C C C C G K K K K K K R T K K K K K K K K K K Q Q Q Q H H H H H H H H H H H H H H H H K K K K 
C C C C C C C K K K K K K K R T K K K K K K K K K Q Q Q Q H H H H H H H L L L H H H H H H H H H H H 
C C C C C C C G K K K K K R R T K K K K K K K K Q Q Q Q Q H H H H L L L L L L L L L H H H H H H H H 
C C C C C C C G K K K K K R R R K K K Q Q Q Q Q Q Q Q Q H H H H L L L L L L L L L L L H H H H H H H 
C C C C C C C G G K K K K R R R K R R R Q Q Q Q Q Q Q H H H H H L L L L L L L L L L L L H H H H H H 
C C C C C C G G G G K K R R R R R R R R Q Q Q Q Q Q Q H H H H L L L L L L L L L L L L L H H H H H H 
C C C C C G G G G G G K R R R R R R R R R Q Q Q Q Q H H H H H L L L L L L L L L L L L L L H H H H H 
C C C G G G G G G G G G R R R R R R R R R R Q Q Q Q H H H H H L L L L L L L L L L L L L L H H H H H 
G G G G G G G G G G G G R R R R D R R R R R Q Q Q Q H H H H H L L L L L L L L L L L L L L H H H H H 
